R 1000 1000
NO ./textures/hell/hell_pent01.xpm
SO ./textures/hell/rock_wall02.xpm
WE ./textures/hell/hell_stone03.xpm
EA ./textures/hell/hell_skin05.xpm
S ./textures/hell/head.xpm
F 220,100,0
C 225,30,0

1111111111111111111111111
1000000000110000002000001
1011000001110000000000001
1001000000000000000000001
1011000001110000000000001
1000000000110000011101111
1111011111111111110000001
1111011111111111110101001
1100200011010101110000001
1000000000000000110000001
1000000000000000110101021
1100000011010101111101111
1111011111110111111101111
1111011111110010110200001
1100000111200000110000001
1000000011000000110000001
1000000011111110111000101
1000000011111111111101001
1100000111000111111001111
1000000010000011010101001
1002000000000000000000021
1000000010000011011101101
1100000111000111111000111
11000001110201111110N0111
1111111111111111111111111