R900 900
C 255,  170,255  
F 0,170,255  

NO textures/111.xpm
SO textures/222.xpm
EA textures/shrek.xpm
WE textures/wall_we.xpm
S textures/sprite.xpm



111111111111
100000000011
100010010001
100001010011
1010110000011
1000101010001
10000000S0001 
1000000000001 
1000000000001
1000002020201   
111111111111
