R  1200 1200


F 207           , 100,10  
C 200,  30,  30

NO /p.xpm
SO      ./path_to_t he_south_texture.xpm
EA ./path_to_the_east_texture.xpm
 WE ./path_to_the_west_texture.xpm
S ./path_to_the_sprite_texture.xpm


11111111111
10000000001111N11111
1000000000000000000111111
1000000001111111110000001
1000000001       10111111
1111011111       101
11111111111111111111

