R 1400 1000
NO ./path_to_the_north_texture.xpm
SO ./path_to_the_south_texture.xpm
WE ./path_to_the_west_texture.xpm
EA ./path_to_the_east_texture.xpm
S ./path_to_the_sprite_texture.xpm
F 0,170,255
C 255,  170,255
        1111111111111111111111111
        1000000000110000000000001
        1011000001110000002000001
        1001000000000000000000001
111111111011000001110000000000001
100000000011000001110111111111111
11110111111111011100000010001
11110111011111011101010000001
11000000110101011100000010001
10002000000000001100000010001
1000000000N000001101010010001
1100000111010101111101111000111
11110111 1110101 101111010001
11111111 1111111 111111111111